##########
#S #     #
#  #     #
#  #     #
#      ###
#        #
#  ####  #
#  #     #
#  #     #
##########