##########
#S #     #
#. #     #
#. #     #
#.     ###
#....... #
#  ####. #
#  #   . #
#  #   . #
##########