##################
#S #             #
#. #         G   #
#. #     #    .  #
#.     ##     .  #
#.......      .  #
#  ####.      .  #
#  #   .         #
#  #   .         #
#  #             #
#. #             #
#. #     #    .  #
#.     ##     .  #
#.......      .  #
#  ####.      .  #
#  #   .  G      #
#                #
##################