##########
#  ###. S#
# . . .  #
# .  #.  #
# . # . ##
# .#  .  #
# .....  #
#  #  ####
#  #  ...#
##########