##################
#S #             #
#. #         G   #
#. #  ############
#. G   ##     .  #
#.......      P  #
#  ####.      .  #
#  #   .##########
#  #   .......   #
#  ###############
#. #   ###########
#. #     #    .  #
#.     ##     .  #
#.......      .  #
#  ####.      .  #
#  #   .  G      #
# #############  #
##################