##############
#G .......  S#
#####.....####
#G .......  P#
# ##### #### #
#P .......  G#
#####.....####
#H .......  G#
# ##### #### #
#P .......  G#
#####.....####
#H .......  G#
#............#
##############