##########
#....  H##
#........#
# G ###..#
#........#
# #    P##
# #  ...G#
# #  ...G#
#S.......#
##########