##########
#  ###. S#
# . . .  #
# .  #. G#
# . # . ##
# .#  . G#
# .....  #
#  #  ####
#  #  ...#
##########