##########
#  ###. S#
# . . .  #
# .  #. G#
# . # . ##
# .#  . G#
# P....  #
#  #H ####
#  #  ...#
##########