############################
#S...........##............#
#.####.#####.##.#####.####.#
#.####.#####.##.#####.####.#
#.####................####.#
#.####.#####.##.#####.####.#
#..........................#
#.####.##.########.##.####.#
#.####.##.########.##.####.#
#......##....##....##......#
# ####.####      ####.#### #
# ####.####      ####.#### #
# ####.####      ####.#### #
# ####.####  GG  ####.#### #
# ####.####  GG  ####.#### #
# ####.####      ####.#### #
# ####.####      ####.#### #
# ####.####      ####.#### #
#......##....##....##......#
#.####.##.########.##.####.#
#.####.##.########.##.####.#
#..........................#
#.####.#####.##.#####.####.#
#.####................####.#
#.####.#####.##.#####.####.#
#.####.#####.##.#####.####.#
#............##............#
############################